##########
#X.2....1#
#..##.B..#
####.....#
#E..A#####
#..3#....#
#...#....#
#3....5.Y#
##########
