200
##########
#X.2....1#
#.######.#
#.#....#.#
#.#.A..#.#
#.#....#.#
#.######.#
#3....5.Y#
##########
