##########
#X.2....1#
#.....B..#
#........#
#E..A...F#
#..3.....#
#........#
#3....5.Y#
##########
